R 1000 500
NO ./north.xpm
SO ./south.xpm
WE ./west.xpm
EA ./east.xpm
S ./sprite.xpm
F 225,30,20
C 0,191,255

1111111111
1000000001
1000000N01
1111111111